#######
#.....#
#.@...# 
#.....#
#######
