######
#....#
#.@..# 
#....#
######
